0000000000000000000000000000
0111111111111111111111111110
0100001001000000001001000010
0300001001000000001001000030
0100001001000000001001000010
0111111001111111111001111110
0000001001000000001001000000
0000001001000000001001000000
1111001001111001111001001111
0001001000001001000001001000
0001001000001001000001001000
0001111001111111111001111000
0001001001000000001001001000
0001001001077777701001001000
0001001111077777701111001000
0001000001077777701000001000
0001000001000000001000001000
0111111111111111111111111110
0100001001000000001001000010
0100001001000000001001000010
0111111001111001111001111110
0001000000001001000000001000
0001000000001001000000001000
1111111001111991111001111111
0001001001000000001001001000
0001001001000000001001001000
0111001111001111001111001110
0100000001001001001000000010
0100000001001001001000000010
0111131111111001111111311110
0000000000000000000000000000
